1001	小米	01
1002	华为	02
1003	格力	03
1004	小米	01
1005	华为	02
1006	格力	03
